#P...#....#....#....
....................
....................
....................
....................
#....#....#....#....
....................
....................
....................
....................
#....#....#....#....
....................
....................
....................
....................
#....#....#....#....
....................
....................
....................
EEEEEEEEEEEEEEEEEEEE
