..#....#..........E.
.........E...##.....
...E.#....E..E..#..#
......#...#.........
..#.E.........E#....
..........E......##.
.#...#.E.#...##.....
.....E..E.E.........
.............#.E....
P...#..#...#....E..#
..#.....E..#...##...
.....#..#...........
.#..........EE...#..
.#..#.....##....#...
.......E............
.#..#....#.....#...E
............E..#....
.#..#..E.......#..E.
.#.........#........
..#....E....E..#....
